7,7,7,7,7,7,7,7,7,7,7,7,7,7,7,
7,89,89,89,89,89,8,89,89,89,89,89,89,89,7,
7,89,89,89,89,89,8,89,89,89,89,89,89,89,7,
7,89,89,89,89,89,8,89,89,89,89,89,89,89,7,
7,89,89,89,89,89,8,89,89,89,89,89,89,89,7,
7,89,89,89,89,89,89,89,89,89,8,89,89,89,7,
7,89,89,89,89,89,89,89,89,89,8,89,89,89,7,
7,89,89,89,89,89,89,89,89,89,8,89,89,89,7,
7,7,7,7,7,7,7,7,7,7,7,7,7,7,7
nextlayer
0,0,0,0,0,0,0,0,0,0,0,0,0,0,0,
0,0,0,0,0,0,0,0,0,0,0,0,0,0,0,
0,0,0,0,0,0,0,0,0,0,0,0,0,0,0,
0,0,0,39,0,0,0,0,0,0,0,0,39,0,0,
0,0,0,0,0,0,0,0,0,0,0,0,0,0,0,
0,0,0,0,0,0,0,0,0,0,0,0,0,0,0,
0,0,0,0,0,0,0,39,0,0,0,0,0,0,0,
0,0,0,0,0,0,0,0,0,0,0,0,0,0,0,
0,0,0,0,0,0,0,0,0,0,0,0,0,0,0
nextlayer
0,0,0,0,0,0,0,0,0,0,0,0,0,0,0,
0,0,0,53,0,0,0,0,0,0,0,0,0,0,0,
0,0,0,0,0,0,0,0,0,0,0,0,0,0,0,
0,0,0,0,0,0,0,0,4,0,0,0,0,0,0,
0,0,0,0,0,0,0,0,0,0,0,0,0,0,0,
0,0,4,0,0,0,0,0,0,0,0,0,0,0,0,
0,0,0,0,0,0,0,0,0,0,0,0,4,0,0,
0,0,0,0,0,0,0,0,0,0,0,0,0,0,0,
0,0,0,0,0,0,0,0,0,0,0,0,0,0,0
end